15 15 4 20
---------A-----
---------------
---------------
---------------
---------------
---------------
---------------
---------------
------_______--
------|--------
------|--------
------|Z-------
------|--------
----J-|------Z-
------|--------