11 12 3 10
------------
------------
-----Z------
--Z------Z--
--Z------Z--
-----J------
------------
----____----
-----ZZ-----
------------
-----A------