16 26 2 20
--A-----------------------
____________----------____
-Z------------------------
__________________|-|_____
---|----|---------|-|-----
---|-Z--|---------|-|-----
J--|----|---------|-|___T-
---|-T--|---------|-------
-__|-___|__T|----_______--
T-------|---|---|--Z---|--
______--|---|---|____--|--
------------|-------|--|--
___________-|---|---|--|--
----------------|-Z-|--|--
----------------|___|-T|--
----Z---------T-----------