11 26 3 10
---------------|----------
---------|-----|------A---
---------|-----|-Z--------
---------|-----|----------
------|--|-----|---______-
------|--|----------------
------|--|-----|----------
------|----Z---|----------
-------------|------------
------|------|------------
-J----|------|-----------Z