14 13 2
------A------
-------------
-------------
---Z-----Z---
______-______
|-----------|
|-----------|
|-----------|
|-----Z-----|
______-______
|-----------|
|-----------|
|J----------|
_____________