11 33 4
--------------------|------------
--------------|-----|--------A---
--------------|-----|-Z----------
--------------|-----|------------
--------|-----|-----|----_______-
--------|-----|------------------
--------|-----|------------------
--------|-------Z----------------
------------------|--------------
--------|---------|--------------
-J------|---------|------Z-------