11 12 2
-----A------
------------
------------
------------
T---Z--Z---T
-----ZZ-----
--TTTTTTTT--
------------
-----J------
------------
------------