15 15 4
---------A-----
---------------
---------------
---------------
---------------
---------------
---------------
---------------
------_______--
------|--------
------|--------
------|Z-------
------|--------
----J-|--------
------|------Z-