15 15
A--------------
---------------
---------------
---------------
---------------
---------------
---------------
---------------
------_______--
------|--------
------|--------
------|---Z----
------|--------
----J-|--------
------|--------