16 26 2 20
--A---T-------------------
------T---------------____
--------B-----------------
__________________|-|_____
---|----|---------|-|-----
-J-|-Z--|---------|-|-----
---|----|---------|-|___T-
---|-T--|---------|-------
-__|-___|__T|----_______--
T-------|---|---|--Z---|--
______--|---|---|____--|--
------------|-------|--|--
___________-|---|---|--|--
----------------|-Z-|--|--
----------------|___|-T|--
----Z---------T-----------