11 12 4
-----A------
------------
------------
------------
----Z--Z----
T----ZZ----T
--TTTTTTTT--
------------
-----J------
------------
------------