15 15 2
---------A-----
---------------
---------------
---------------
---------------
---------------
---------------
---------------
------_______--
------|--|-----
------|--|-----
------|Z-|-----
------|--|-----
----J-|------Z-
------|--------